aegilnt -> atingle gelatin genital 
ciilost -> colitis solicit 
eeilnrty -> entirely lientery 
eefinr -> ferine refine 
aegilnss -> gainless glassine 
aegilnst -> genitals stealing 
ehnort -> hornet throne 
aegilnrt -> integral triangle 
 aceiklrrrttu -> trailer truck truck trailer 
flow -> flow fowl wolf 
elmno -> lemon melon 
ceerst -> certes resect secret 
ceersu -> cereus ceruse rescue secure 
abcekpstw -> backswept sweptback 
acehpr -> eparch preach 
adnor -> adorn radon 
acehst -> chaste sachet scathe 
acehrs -> chaser eschar search 
eimorrttw -> miterwort mitrewort 
eehorvw -> however whoever 
aeoprst -> esparto seaport 
aeoprrt -> praetor prorate 
cgilmnuu -> cingulum glucinum 
abenry -> barney nearby 
adinor -> inroad ordain 
acehms -> sachem schema 
 aabcklrt -> black art black rat 
acehlp -> chapel pleach 
acehor -> chorea ochrea 
ikrst -> skirt stirk 
cdeiins -> incised indices 
korst -> stork torsk 
..BMsu -> B.Mus. Mus.B. 
chlru -> churl lurch 
aanprt -> partan tarpan trapan 
beglnu -> blunge bungle 
fmor -> form from 
aegilors -> gasolier seraglio 
ceorssu -> courses sucrose 
bhrsu -> brush shrub 
 aabckklt -> back talk talk back 
admno -> monad nomad 
Saeent -> Santee Senate 
abeort -> boater borate rebato 
aceimn -> anemic cinema iceman 
aceins -> casein incase 
loops -> sloop spool 
DM -> DM MD 
FM -> FM MF 
elosu -> louse ousel 
elotw -> owlet towel 
alprty -> paltry partly 
cdeilnu -> include nuclide 
elorw -> lower rowel 
ceeptx -> except expect 
adoty -> toady today 
bblu -> blub bulb 
abeltt -> battle tablet 
chiilt -> litchi lithic 
abelmr -> marble ramble 
abelnu -> nebula unable 
abelot -> boatel lobate oblate 
aemrst -> master stream 
abelry -> barely barley bleary 
abbdillor -> billboard broadbill 
abelsu -> suable usable 
-aemnot -> nemato- to-name 
ah -> ah ha 
am -> am ma 
eeflru -> ferule refuel 
at -> at ta 
do -> do od 
eh -> eh he 
em -> em me 
er -> er re 
ho -> ho oh 
elnor -> enrol loner 
is -> is si 
it -> it ti 
eghlnoopy -> nephology phenology 
aiilnpst -> alpinist tailspin 
lm -> lm ml 
no -> no on 
cdnoor -> condor cordon 
os -> os so 
ow -> ow wo 
aceelnrtu -> calenture crenulate 
ceenrs -> censer screen secern 
ceenrt -> center centre recent tenrec 
aceiimnorst -> anisometric creationism 
aemsty -> mayest steamy 
eeinrtty -> entirety eternity 
acceennortt -> concentrate concertante 
adimno -> daimon domain 
deeginr -> energid reeding 
adeggr -> dagger ragged 
cdeor -> credo decor 
cdery -> cyder decry 
aabcelnr -> balancer barnacle 
cdeinrs -> discern rescind 
Aagnor -> Angora Aragon 
elmpru -> lumper rumple 
Sailmo -> Siloam Somali 
acelqu -> calque claque 
aeilnv -> alevin alvine valine venial 
aeilnr -> larine linear 
aeilnp -> alpine pineal 
acelpr -> carpel parcel placer 
acelrs -> scaler sclera 
acelrt -> cartel claret rectal 
acelrv -> carvel claver 
aeilms -> mesial samiel 
ceiorrs -> cirrose crosier 
acdiinot -> actinoid diatonic 
aeilrs -> sailer serial 
aeilps -> espial lipase 
abettu -> battue tubate 
beer -> beer bree 
loppy -> loppy polyp 
beir -> bier brei 
aeinns -> insane sienna 
beik -> bike kibe 
acenst -> ascent secant stance 
egnrtu -> gunter urgent 
acenrt -> canter carnet centra nectar recant trance 
acenrv -> carven cavern craven 
belo -> bole lobe 
beor -> bore robe 
beno -> bone ebon 
aeeginrtt -> argentite integrate 
cenoru -> conure rounce 
ceinootz -> entozoic enzootic 
achmnory -> monarchy nomarchy 
adegrr -> grader regard 
aceehmrs -> cashmere marchese 
cdeeu -> deuce educe 
delnou -> louden nodule 
aeimnr -> marine remain 
adegos -> dosage seadog 
adegnr -> danger gander garden ranged 
admrstu -> durmast mustard 
eirsst -> resist sister 
eirstv -> stiver strive 
eirstt -> sitter triste 
acilopt -> capitol optical topical 
aenprtt -> pattern reptant 
ehinoprsw -> ownership shipowner 
chimrs -> chrism smirch 
amnos -> mason monas 
amnor -> manor roman 
eeimprrssu -> impressure presurmise 
adiprs -> rapids sparid 
aberrt -> barret barter 
aanrtt -> rattan tartan 
acelms -> mascle mescal 
aeilloppt -> papillote popliteal 
abertt -> batter tabret 
acelmu -> almuce macule 
acellr -> caller cellar recall 
bgoy -> bogy goby 
acelor -> coaler oracle 
acelov -> alcove coeval 
acelnt -> cantle cental lancet 
aegilmnr -> germinal malinger 
acelnu -> cuneal launce unlace 
bgru -> burg grub 
aaceglotu -> catalogue coagulate 
delnrtu -> rundlet trundle 
einosuv -> envious niveous 
adeers -> erased reseda 
aegilnot -> gelation legation 
adeehr -> adhere header 
acekrs -> sacker screak 
adeelt -> delate elated 
adeelr -> dealer leader 
..BCh -> B.Ch. Ch.B. 
ehisv -> hives shive 
ehitw -> white withe 
diknnu -> nudnik unkind 
Caabimr -> Cambrai Cambria 
ehirs -> shier shire 
ddeeinnt -> indented intended 
floru -> flour fluor 
cegorsu -> scourge scrouge 
ceeipr -> pierce recipe 
ceeirt -> recite tierce 
oott -> otto toot 
Saennr -> Sarnen Sennar 
ghnostu -> gunshot shotgun 
adforrw -> forward froward 
aeeginnrt -> argentine tangerine 
acilnor -> clarino clarion 
ciilnoptu -> punctilio unpolitic 
abeglu -> beluga blague 
aellorv -> allover overall 
abegnr -> banger graben 
amory -> mayor moray 
bdehnrrsuu -> underbrush undershrub 
opru -> pour roup 
opst -> post spot stop tops 
opsu -> opus soup 
aaeehrtw -> aweather wheatear 
egnory -> eryngo groyne 
norttuu -> outturn turnout 
ehlot -> helot hotel thole 
elmnot -> loment melton molten 
aainprst -> aspirant partisan 
aceiprst -> crispate practise 
aacdeln -> candela decanal 
cdlou -> cloud could 
elmnpu -> lumpen plenum 
aaeiprst -> aspirate parasite 
aegmnrt -> garment margent 
aegmnot -> magneto megaton montage 
aeeeprrt -> repartee repeater 
ceeinrsu -> insecure sinecure 
abeert -> beater berate rebate 
ccersu -> cercus cruces 
abeeln -> baleen enable 
abeemn -> bemean bename 
cdemnoow -> comedown downcome 
deiostu -> outside tedious 
aeeimnt -> etamine matinee 
blot -> blot bolt 
bloo -> bolo lobo 
ortu -> rout tour 
ortw -> trow wort 
ortt -> tort trot 
blow -> blow bowl 
orty -> troy tyro 
orst -> orts sort 
orsu -> ours sour 
aginors -> signora soaring 
blru -> blur burl 
aceelnort -> coeternal tolerance 
defhiins -> fiendish finished 
ehioprsst -> prothesis sophister 
bdeortu -> obtrude redoubt 
imnosy -> myosin simony 
cgimno -> coming gnomic 
ehnop -> pheon phone 
ostw -> stow swot 
deiorst -> steroid storied 
deiorsv -> devisor devoirs 
aginprs -> rasping sparing 
aeeilpt -> epilate pileate 
deiopst -> deposit topside 
aceert -> cerate create 
ehmor -> homer horme 
aceemr -> amerce raceme 
acghinr -> arching chagrin 
aceent -> cetane tenace 
eiilnos -> elision isoline 
aeekortv -> overtake takeover 
ceeinort -> erection neoteric 
Haert -> Harte Herat 
fhirt -> firth frith 
Lacertu -> Lautrec Leuctra 
acehrtt -> chatter ratchet 
aaablt -> albata balata 
abehrt -> bertha breath 
noops -> snoop spoon 
bost -> bots stob 
acinot -> action atonic cation 
ilnstu -> insult sunlit 
Hadny -> Handy Haydn 
Hadry -> Hardy Hydra 
eeprrss -> presser repress 
ehost -> ethos shote those 
abeirs -> braise rabies 
abeirt -> barite terbia 
ehors -> horse shoer shore 
ehort -> other throe 
aimnnos -> mansion onanism 
ceiilnos -> isocline silicone 
cdors -> cords scrod 
abeilt -> albeit albite 
abeill -> alible labile liable 
-ooprt -> proto- tropo- 
agimnr -> arming margin 
aersuu -> aureus uraeus 
dhlopu -> holdup uphold 
aerstt -> stater taster 
cdeiorrt -> creditor director 
iprst -> spirt sprit strip 
ailrv -> rival viral 
ailrt -> trail trial 
ehrsw -> shrew wersh 
aoprrt -> parrot raptor 
elrstu -> luster lustre result rustle sutler ulster 
aehinntx -> xanthein xanthine 
ailns -> slain snail 
ailnv -> anvil nival 
ailnp -> lapin plain 
aefiinnostt -> festination infestation sinfonietta 
aginrt -> gratin rating 
aimnst -> mantis matins stamin 
aceehrt -> cheater hectare teacher 
aeeinrsstw -> earwitness wateriness 
eilmntuy -> minutely untimely 
acfinrt -> frantic infarct infract 
-aehmot -> at-home hemato- 
ceikrst -> rickets sticker 
aeenst -> sateen senate 
aceoortv -> evocator overcoat 
abcekoos -> bookcase casebook 
acdeort -> cordate redcoat 
eijnor -> joiner rejoin 
aghilnt -> halting lathing 
achmnor -> monarch nomarch 
bruy -> bury ruby 
kloo -> kolo look 
.Port -> Port. Prot. 
ceiimorst -> eroticism isometric 
ainpt -> inapt paint patin pinta 
aeemnsttt -> statement testament 
 aaeilnoppry -> piano player player piano 
efoort -> foetor footer 
nostu -> snout tonus 
bstu -> bust stub 
ghhit -> hight thigh 
ceelort -> elector electro 
ainrt -> riant train 
ainst -> saint satin stain 
aintt -> taint titan 
aeelrs -> resale sealer 
aeelrt -> elater relate 
begilllu -> bluegill gullible 
aeelsv -> leaves sleave 
agilmn -> lingam malign 
aeelpr -> leaper repeal 
aeelps -> asleep elapse please sapele 
aaffir -> affair raffia 
aderrw -> drawer reward warder 
aderrt -> darter retard retrad trader 
aerrst -> arrest raster 
aceirsv -> varices viscera 
aceirrt -> cirrate erratic 
 hoopstt -> hot spot pot shot 
aiprt -> atrip tapir 
acdeirs -> radices sidecar 
 oopttu -> opt out top out 
acdeilr -> decrial radicel radicle 
acdeilt -> citadel deltaic dialect 
acdeilm -> decimal declaim medical 
aceeennprt -> penetrance repentance 
koot -> koto took 
 aadeeehllrttty -> lead tetraethyl tetraethyl lead 
ceeorrsu -> recourse resource 
ilopst -> pistol spoilt 
Laadnu -> Landau Luanda 
aacilloprt -> allopatric patrilocal 
ceeinnoorrt -> reconnoiter reconnoitre 
celoptu -> couplet octuple 
acceiimnost -> cosmetician encomiastic 
aceipst -> aseptic spicate 
belorw -> blower bowler 
aceippr -> crappie epicarp 
ghirt -> girth grith right 
aeenrst -> earnest eastern 
ghint -> night thing 
aeerst -> reseat teaser 
aeersu -> reseau urease 
aeenrtt -> entreat ternate 
cirstu -> citrus rictus rustic 
fhort -> forth froth 
cmoru -> mucor mucro 
enorrtuv -> overturn turnover 
aefkr -> faker freak 
aeflm -> flame fleam 
aeflr -> feral flare 
cehimort -> chromite trichome 
eilpprt -> ripplet tippler 
airst -> astir sitar stair stria 
aefir -> afire feria 
bdelloor -> bordello doorbell 
illsy -> silly slily 
acenorstu -> courtesan nectarous 
ghlou -> ghoul lough 
gortuy -> grouty yogurt 
cdeeoprru -> procedure reproduce 
aadmnry -> drayman yardman 
cenorsuu -> cernuous coenurus 
aimprt -> armpit impart 
aeegr -> agree eager eagre 
egnopry -> progeny pyrogen 
celortu -> cloture coulter 
aailmrt -> marital martial 
ooprs -> sopor spoor 
belmru -> lumber rumble 
dinoors -> indoors sordino 
aeels -> easel lease 
aeent -> eaten enate 
aehnt -> neath thane 
binru -> bruin burin 
aehps -> phase shape 
adekmr -> demark marked 
aehlw -> whale wheal 
aehls -> leash selah shale 
aeennpt -> pennate pentane 
.abl -> abl. bal. lab. 
abcksuw -> bucksaw sawbuck 
.abr -> abr. bar. 
.alt -> alt. lat. 
.amp -> amp. pam. 
.amt -> amt. atm. 
.anv -> avn. nav. 
Danu -> Danu Duna 
.apt -> apt. pat. 
adegorw -> dowager wordage 
aehrt -> earth heart rathe 
aehrs -> share shear 
cceeginort -> egocentric geocentric 
aegln -> angel angle glean 
aceiltt -> lattice tactile 
aeglr -> glare lager large regal 
adelmr -> dermal medlar 
ceepprt -> percept precept 
adellu -> allude aludel 
dhimoru -> humidor rhodium 
aceilst -> elastic latices 
aegnr -> anger range 
aegno -> agone genoa 
aceilrt -> article recital 
aceilrv -> clavier valeric 
adelor -> loader ordeal 
aceilpr -> caliper replica 
aceilor -> calorie cariole 
aceilnp -> capelin panicle pelican 
aeirtt -> attire ratite 
aceilmr -> miracle reclaim 
dehnor -> dehorn horned 
.bdl -> bdl. dbl. 
acersu -> cesura saucer 
acerrt -> crater tracer 
oorst -> roost torso 
abekortu -> breakout outbreak 
eghlooty -> ethology theology 
aaceilnnt -> cantilena lancinate 
cgiinnoot -> cognition incognito 
einrst -> estrin insert sinter 
einrsu -> insure ursine 
aegru -> argue auger 
aegrt -> grate great targe 
cnoortu -> contour crouton 
abnory -> barony baryon 
abgilmnr -> marbling rambling 
acceimr -> ceramic racemic 
aclmorssttuuu -> cumulostratus stratocumulus 
acceino -> cocaine oceanic 
adeimn -> maiden median 
aceotv -> avocet octave 
acdiopr -> parodic picador 
adeilt -> detail dilate 
adeilp -> aliped elapid pleiad 
adeilm -> mailed medial 
.cen -> cen. enc. 
beilrst -> blister bristle 
.chs -> chs. sch. 
gikn -> gink king 
ginr -> grin ring 
gins -> sign sing 
cdeeilp -> pedicel pedicle 
abehiimorsv -> behaviorism misbehavior 
gipr -> grip prig 
egilrst -> glister gristle 
girt -> girt grit trig 
aeimnoprttu -> importunate permutation 
aeinrt -> retain retina 
ilpst -> spilt split 
aeinpr -> panier rapine 
ceiklrt -> tickler trickle 
adehrt -> dearth hatred thread 
aeirs -> arise raise serai 
aceprs -> escarp parsec scrape 
aeiln -> alien aline anile 
aeiprs -> aspire paries praise 
aeiprr -> rapier repair 
aeint -> tenia tinea 
ceiklnr -> clinker crinkle 
.dep -> dep. ped. 
acehhrty -> hatchery thearchy 
.dgs -> gds. sgd. 
ceeprst -> respect scepter sceptre specter spectre 
.dim -> dim. mid. 
ahilopss -> alphosis haplosis 
.dmo -> dom. mod. 
abeortt -> abettor taboret 
abehnorrt -> abhorrent earthborn 
hopstu -> tophus upshot 
ahostuw -> outwash washout 
einprrt -> printer reprint 
ceffioru -> coiffeur coiffure 
ilops -> polis spoil 
ghotu -> ought tough 
aeimpst -> impaste pastime 
aelry -> early layer relay 
aelrv -> laver ravel velar 
aelrt -> alert alter artel later ratel taler 
agiiln -> ailing nilgai 
aelsv -> salve slave valse 
aelst -> least slate stale steal stela tales tesla 
acdimno -> monacid nomadic 
aeltx -> exalt latex 
.egn -> eng. gen. 
aelnr -> learn neral renal 
aelnp -> panel penal plane 
aelno -> alone anole 
aelnv -> navel venal 
aelpt -> leapt petal plate pleat 
aelps -> lapse salep sepal 
aelpp -> appel apple 
befir -> brief fiber fibre 
acnoor -> corona racoon 
acnort -> cantor carton contra 
aelmp -> ample maple 
.epr -> per. rep. 
dehino -> hoiden honied 
aeehrs -> haeres hearse 
aeehrt -> aether heater hereat reheat 
aeehsv -> heaves sheave 
eesstt -> sestet testes 
accehor -> caroche coacher 
aekps -> spake speak 
einnst -> sennit tennis 
accehil -> caliche chalice 
aekst -> skate stake steak 
einnrt -> intern tinner 
.fin -> fin. inf. 
deforst -> defrost frosted 
aekns -> skean snake sneak 
glpu -> gulp plug 
aefgirtu -> figurate fruitage 
cdeinortu -> introduce reduction 
adeprt -> depart parted petard 
aeelrrstuw -> lusterware lustreware 
aeeegnrt -> generate teenager 
Gadiru -> Giraud Guardi 
aabnw -> bwana nawab 
aeginrt -> granite ingrate tearing 
aeimnor -> moraine romaine 
ademns -> amends desman 
einort -> norite orient 
aeimnrs -> remains seminar 
aeimnrt -> minaret raiment 
aeeglt -> eaglet legate telega 
ademsu -> amused medusa 
aeegmt -> gamete metage 
cinru -> incur runic 
aeegmr -> meager meagre 
aabls -> balas balsa basal 
einoss -> enosis noesis ossein 
cintu -> cutin tunic 
aeginst -> easting genista ingesta seating 
cinos -> scion sonic 
aenrs -> nares snare 
aenst -> nates stane 
.gor -> gro. org. 
aennp -> panne penna 
aeginnt -> antigen gentian 
aeginnu -> anguine guanine 
aenot -> atone oaten 
acesuy -> causey cayuse 
aabem -> abeam ameba 
Main -> Main Mani 
adegiln -> dealing leading 
adiimnnoot -> admonition domination 
adeginr -> deraign grained reading 
egilnst -> glisten singlet 
aeimnty -> amenity anytime 
einpst -> instep spinet 
einpsu -> puisne supine 
adenpt -> pedant pentad 
adenpr -> pander repand 
adenrw -> wander warden 
adenrr -> darner errand 
einpru -> purine unripe 
aemty -> matey meaty 
beglo -> bogle globe 
beglu -> bugle bulge 
aegimrt -> migrate ragtime 
aaeilstv -> aestival salivate 
begin -> begin being binge 
aemrs -> maser smear 
cimnu -> cumin mucin 
aemst -> satem steam 
aeerstt -> estreat restate 
gnsu -> snug sung 
aemns -> manes manse means 
aemnt -> ament meant 
ddeilops -> displode lopsided 
aemny -> meany yamen 
arstw -> straw swart 
acnnot -> cannot canton 
arsty -> satyr stray 
cdgilno -> codling lingcod 
aeeeglrt -> regelate relegate 
dilossu -> dulosis solidus 
aeegnv -> avenge geneva 
aeegnr -> enrage genera 
admnort -> dormant mordant 
efillr -> filler refill 
eeirvw -> review viewer 
eehlnopty -> polythene telephony 
efilst -> itself stifle 
efilrt -> filter trifle 
gory -> gory gyro orgy 
ciprs -> crisp scrip 
cciirt -> citric critic 
aadmn -> adman daman 
aadmr -> damar drama 
aeprt -> pater peart prate taper 
aeprs -> asper parse prase presa spare spear 
aepry -> apery payer repay 
aepst -> paste septa spate 
cceeinortz -> concertize concretize 
acdent -> cadent decant 
acdeno -> acnode deacon 
acdenr -> dancer nacred 
aaegl -> algae galea 
eehnorw -> nowhere whereon 
einnooprt -> pontonier prenotion 
emott -> motet motte totem 
emorv -> mover vomer 
emors -> mores morse 
cdei -> dice iced 
 aaeglmprsu -> maple sugar sugar maple 
ciopt -> optic picot topic 
cdlo -> clod cold 
ceinrttu -> intercut tincture 
aloruv -> louvar ovular 
cdru -> crud curd 
rsttu -> strut trust 
aelrst -> salter slater 
aelrsv -> salver serval slaver 
aelrtt -> latter rattle 
aelrtv -> travel varlet 
aelrty -> lyrate realty 
eiimnorss -> missioner remission 
efinst -> feints infest 
agllntu -> gallnut nutgall 
ceht -> echt etch 
ceip -> epic pice 
ceil -> ceil lice 
celu -> clue luce 
ceno -> cone once 
below -> below bowel elbow 
dilly -> dilly idyll 
cefhi -> chief fiche 
ceor -> cero core 
accdeeilmnorty -> dynamoelectric electrodynamic 
aestt -> state taste testa 
ceru -> cure ecru 
aestw -> sweat waste 
aestv -> stave vesta 
eiprstt -> spitter tipster 
einnoorst -> ironstone serotonin 
aacilmnt -> calamint claimant 
aesst -> asset tasse 
  abehnorstty -> east by north north by east 
abdilr -> bridal ribald 
 beilnprsuy -> ruby spinel spinel ruby 
aelmnops -> neoplasm pleonasm 
aeehrtw -> weather whereat wreathe 
aeehrtt -> theater theatre thereat 
ceepr -> creep crepe 
ceert -> erect terce 
cfio -> coif fico 
ceens -> cense scene 
aloprt -> patrol portal 
aaenp -> apnea paean 
aaenr -> anear arena 
adgnoor -> dragoon gadroon 
deeeloprv -> developer redevelop 
aerst -> aster stare tears 
aersw -> swear wares 
aelpst -> pastel septal staple 
aertt -> tater tetra treat 
cenortu -> cornute counter recount trounce 
aertv -> avert trave 
aenorst -> senator treason 
Gdnoor -> Gordon Grodno 
aceinnoorstv -> conservation conversation 
aabcdeorrst -> broadcaster rebroadcast 
ceiprtu -> cuprite picture 
aelprt -> palter plater 
aelpry -> parley pearly player replay 
.mno -> mon. nom. 
aeelnrtv -> levanter relevant 
Mennot -> Menton Monnet 
aiilmrty -> limitary military 
cehrt -> chert retch 
aaeghmnopr -> anemograph phanerogam 
egmnor -> monger morgen 
cehor -> chore ocher ochre 
Beeghlru -> Breughel Brueghel 
efghirt -> fighter freight 
aailn -> lanai liana 
'ahnst -> hasn't shan't 
anors -> arson sonar 
aaimn -> amain anima mania 
beors -> brose sober 
aiooprsuv -> apivorous oviparous 
Menort -> Mentor Merton 
chin -> chin inch 
chit -> chit itch 
chmu -> chum much 
cceeeeinprt -> centerpiece centrepiece 
chou -> chou ouch 
aagmm -> gamma magma 
cistu -> cutis ictus 
aagnp -> pagan panga 
bemru -> brume umber 
bemsu -> embus sebum 
benor -> boner borne 
cehin -> chine niche 
aenoprt -> operant pronate protean 
aeglpru -> earplug graupel 
cilo -> coil loci 
cino -> coin icon 
aadgmnr -> grandam grandma 
aceiinprtty -> antipyretic pertinacity 
deegl -> glede ledge 
deegr -> edger greed 
aflmru -> armful fulmar 
eeilnoprt -> interlope repletion terpineol 
ellovy -> lovely volley 
abdenor -> bandore broaden 
aceprst -> precast spectra 
aelstu -> salute setula 
aceprrs -> scarper scraper 
aakky -> kayak yakka 
aimnnoty -> antimony antinomy 
ceitv -> civet evict 
immstu -> mutism summit 
abegmnoy -> bogeyman moneybag 
aabcillsy -> asyllabic basically 
ceirr -> crier ricer 
ceirt -> recti trice 
ceilm -> clime melic 
aairt -> riata tiara 
ehlrsstu -> hurtless ruthless 
aeegoprrt -> porterage reportage 
alotuy -> layout outlay 
aciinoprst -> ascription crispation 
cdeeiinrst -> indiscreet indiscrete iridescent 
aceinnort -> container crenation 
aeehnrt -> earthen hearten 
aeimortz -> amortize atomizer 
deginnorst -> grindstone stringendo 
giilnn -> lignin lining 
acdefiiinot -> deification edification 
 adfforw -> draw off ward off 
ckno -> conk nock 
ckor -> cork rock 
aceeilmnst -> centesimal lemniscate 
aeiinpssst -> antisepsis inspissate 
cksu -> cusk suck 
eilrt -> liter litre 
eilrv -> liver livre 
eilst -> islet istle stile 
eilpr -> peril plier 
eilps -> piles spiel spile 
aaacmrs -> marasca mascara 
celru -> cruel lucre ulcer 
eilns -> lenis lines 
eilnv -> levin liven 
eilor -> oiler oriel 
eilov -> olive voile 
aemnorsty -> monastery oysterman 
degil -> gelid glide 
degin -> deign dinge 
degio -> dogie geoid 
degir -> dirge gride ridge 
eimox -> moxie oxime 
acehostu -> cathouse soutache 
crstu -> crust curst 
achipt -> pathic phatic 
aamnt -> atman manta 
ansty -> nasty tansy 
abeirrz -> bizarre brazier 
abeirrt -> arbiter rarebit 
aiinorttt -> attrition titration 
deorsw -> dowser drowse 
abefiort -> biforate fireboat 
Sadehlnt -> Shetland Stendhal 
clot -> clot colt 
cloo -> cool loco 
aaegilnt -> agential alginate 
cloy -> cloy coly 
deesw -> swede weeds 
deesx -> desex sexed 
deert -> deter treed 
deens -> dense needs 
eikno -> eikon koine 
deeil -> edile elide 
acceortu -> accouter accoutre 
eikln -> inkle liken 
aalrt -> altar ratal 
celos -> close socle 
deeflorw -> deflower flowered 
eilms -> limes slime smile 
defiy -> deify edify 
defil -> felid field flied 
kloootu -> lookout outlook 
aegllry -> allergy gallery largely 
ghilst -> lights slight 
bersu -> burse rebus 
adilorty -> dilatory idolatry 
bertu -> brute rebut tuber 
aalpp -> appal papal 
Negor -> Negro Norge 
aabcert -> abreact bearcat cabaret 
eeinrrt -> rentier terrine 
aalmr -> alarm malar 
eeinrtu -> retinue reunite uterine 
aginorst -> organist roasting 
aegllno -> allonge galleon 
aehmorrtw -> earthworm heartworm 
eeilns -> enisle ensile senile 
dehrs -> sherd shred 
eeilrv -> relive revile 
adenrsu -> asunder danseur 
einwz -> winze wizen 
eintu -> unite untie 
koortuw -> outwork workout 
Maden -> Mande Medan 
Madee -> Meade Medea 
einrs -> reins resin rinse serin siren 
einrt -> inert inter niter nitre trine 
einru -> inure urine 
einst -> inset stein 
einsw -> sinew swine 
deils -> sidle slide 
adlmno -> almond dolman 
ceops -> copse scope 
bnosu -> bonus bosun 
ceors -> corse score 
immnos -> monism nomism 
aeefgorst -> forestage fosterage 
cdiioprt -> dioptric tripodic 
acceinstu -> encaustic succinate 
cehilorsty -> chrysolite chrysotile 
cdeiinnoort -> conditioner recondition 
eimrt -> merit miter mitre remit timer 
einps -> penis snipe spine 
einnr -> inner renin 
cehort -> hector rochet troche 
einos -> eosin noise 
einov -> envoi ovine 
eeforrst -> forester reforest 
cenot -> cento conte 
Moor -> Moor Moro 
coop -> coop poco 
cost -> cost scot 
abdegir -> abridge brigade 
abdegno -> bondage dogbane 
beffru -> buffer rebuff 
acdeimno -> comedian demoniac 
acdeiilmn -> adminicle medicinal 
--aadeelnppprst -> pepper-and-salt salt-and-pepper 
bdenoru -> bounder rebound 
eiqtu -> quiet quite 
aelmnt -> lament mantel mantle mental 
aelmny -> meanly namely 
 eeehiimpprrstuv -> heir presumptive presumptive heir 
cpsu -> cusp scup 
 EIVaddrw -> Edward IV Edward VI 
dintuy -> nudity untidy 
Pceeir -> Peirce Pierce 
eioprsuv -> pervious previous viperous 
  abehossttuy -> east by south south by east 
eehlopst -> heelpost pesthole 
deirr -> drier rider 
deirt -> tired tried 
deirv -> diver drive 
achntu -> chaunt nautch 
aelnrt -> antler learnt rental 
aelnru -> neural unreal 
aelnrv -> nerval vernal 
achnst -> snatch stanch 
ceehlry -> cheerly lechery 
eiprs -> prise spier spire 
abeerrtt -> barrette berretta 
aelnpt -> planet platen 
eeinnrv -> innerve nervine 
eipst -> piste spite stipe 
aehimpss -> emphasis misshape 
aciorsu -> carious curiosa 
eipqu -> equip pique 
Maens -> Manes Mensa 
aelntt -> latent latten talent 
gginor -> goring gringo 
aegmnrtu -> argentum argument 
lloty -> tolly tolyl 
achnor -> anchor archon rancho 
aceiinottx -> excitation intoxicate 
denorru -> rondure rounder 
.ae -> ae. ea. 
abcekst -> backset setback 
.bl -> bl. lb. 
.cp -> cp. pc. 
.cs -> cs. sc. 
.di -> di. id. 
eefrr -> freer refer 
.dr -> dr. rd. 
aelorrt -> realtor relator 
.gl -> gl. lg. 
denorsu -> resound sounder 
.km -> km. mk. 
eegnr -> genre green 
abdelm -> bedlam beldam blamed 
abdelo -> albedo doable 
.ps -> ps. sp. 
.rt -> rt. tr. 
demno -> demon monde 
deoprt -> deport redtop 
abcelmr -> cambrel clamber 
abeilmt -> limbate timbale 
adenopr -> operand padrone 
/co -> c/o o/c 
abeilst -> astilbe bestial stabile 
abeilrt -> librate triable 
aceeilnnort -> crenelation intolerance 
efmorr -> former reform 
acdeiilrv -> larvicide veridical 
 cghilop -> chip log log chip 
cehsty -> chesty scythe 
deloy -> yodel yodle 
eirtt -> titer titre trite 
aellru -> allure laurel 
delno -> loden olden 
acioprt -> apricot parotic 
acginnoot -> cognation contagion 
aceennortv -> contravene covenanter 
eirrw -> wirer wrier 
cersu -> cruse curse sucre 
ailnopstu -> platinous pulsation 
bnrtu -> brunt burnt 
certu -> cruet curet eruct truce 
lmpu -> lump plum 
eeinpsv -> pensive vespine 
 aeefilmnr -> frame line leaf miner 
 acddeinrx -> card index index card 
.cehm -> chem. mech. 
egiopru -> groupie pirogue 
eehst -> sheet these 
eehrt -> ether there three 
eehrs -> heres sheer 
acehpry -> eparchy preachy 
.cert -> cert. rect. 
agilnst -> lasting slating 
hmoru -> humor mohur 
cdeinort -> centroid doctrine 
aefmnor -> foramen foreman 
eelrstw -> swelter wrestle 
cnory -> corny crony 
eelrstt -> letters settler trestle 
ceimsu -> cesium miscue 
ceehnrrt -> retrench trencher 
bbbelru -> blubber bubbler 
aelprst -> plaster stapler 
aelprtt -> partlet platter prattle 
eegst -> egest geest 
eegrt -> egret greet 
eenrtu -> neuter tenure tureen 
loop -> loop polo pool 
loot -> loot tool 
Caaeenrs -> Canarese Cesarean 
lost -> lost lots slot 
ajntu -> jaunt junta 
ceilnt -> client lentic 
aailnort -> notarial rational 
lotu -> lout tolu 
bgilnow -> blowing bowling 
aainpt -> patina taipan 
acehnrt -> chanter tranche 
acmnos -> mascon socman 
abcjkoot -> bootjack jackboot 
ehirsv -> shiver shrive 
ehirtw -> wither writhe 
aaceilln -> alliance canaille 
cdeeer -> decree recede 
eilortt -> tortile triolet 
aegillorst -> allegorist legislator 
acnoort -> cartoon coranto 
abbbelr -> babbler blabber brabble 
belorst -> bolster lobster 
-aertt -> terat- tetra- 
bdennou -> bounden unboned 
ginors -> grison signor 
beorwy -> bowery bowyer 
acdeeimt -> decimate medicate 
ehisst -> shiest thesis 
ceeinorst -> resection secretion 
depru -> drupe perdu prude 
aeeglmort -> algometer glomerate 
aceilnost -> coastline sectional 
Dabnru -> Dunbar Durban 
aceilrtuv -> lucrative victualer 
acehltt -> chattel latchet 
ailnps -> plains spinal 
ailnpt -> plaint pliant 
acehlor -> cholera chorale 
aaclprsu -> capsular scapular 
ghnotu -> hognut nought 
cdekor -> corked docker 
bbcelor -> clobber cobbler 
abinos -> basion bonsai 
oprst -> sport strop 
eeertt -> teeter terete 
abinry -> binary brainy 
eimrsv -> verism vermis 
eimrst -> merits mister 
eemrt -> meter metre 
afgno -> fango ganof 
erstw -> strew trews wrest 
eemns -> mesne semen 
Cdnoory -> Corydon Croydon 
ailort -> rialto tailor 
aaegtwy -> gateway getaway 
acehmrr -> charmer marcher 
degoru -> drogue gourde 
aadeginr -> drainage gardenia 
eeestt -> settee testee 
lstu -> lust slut 
 ILXiosu -> Louis IX Louis XI 
eelst -> sleet steel stele 
  behossttuwy -> south by west west by south 
eelrv -> elver lever revel 
dioosu -> iodous odious 
eelpr -> leper repel 
adeiilmnor -> meridional mineraloid 
derry -> derry dryer 
aeghopprrty -> petrography typographer 
ehimrt -> hermit mither 
 beloorvw -> blow over bowl over 
dnoor -> donor rondo 
afilr -> filar flair frail 
 acceikp -> ice pack pack ice 
dioprt -> torpid tripod 
aeemmrt -> ammeter metamer 
acdeinoort -> carotenoid coordinate decoration 
aairst -> arista tarsia 
acinnorst -> constrain transonic 
ehinrs -> shiner shrine 
cdeirt -> credit direct 
aeeinrst -> arsenite resinate 
dnosu -> nodus sound 
aeilrst -> realist saltire 
aaeillpss -> paillasse palliasse 
aeelssstt -> stateless tasteless 
eenopr -> opener reopen 
hins -> shin sinh 
hint -> hint thin 
aaeglr -> alegar laager 
aaegln -> anlage galena lagena 
opstu -> spout stoup 
hips -> pish ship 
eenst -> teens tense 
hist -> hist shit this 
ceinst -> incest insect 
eenrv -> nerve never 
eenrt -> enter treen 
Aalnov -> Avalon Avlona 
ginot -> ingot tigon 
hitw -> whit with 
ceinos -> cosine oscine 
ceinot -> noetic notice 
ceinqu -> cinque quince 
aaegintv -> navigate vaginate 
eenpr -> neper preen 
ceinpr -> pincer prince 
ceinpt -> incept pectin 
cehilnop -> phenolic pinochle 
aeilqtu -> liquate tequila 
aehnrt -> anther thenar 
eimntu -> minuet minute 
aaegilnpp -> appealing lagniappe 
eilmopst -> milepost polemist 
eeilprsuv -> prelusive repulsive 
eeenrt -> entree eterne retene 
eginor -> eringo ignore region 
einoprt -> pointer protein tropine 
ddenoru -> redound rounded 
eimnos -> eonism monies 
eginsw -> sewing swinge 
eginst -> ingest signet 
eginrr -> erring ringer 
eginrs -> resign singer 
cehilort -> chlorite clothier 
eimors -> isomer rimose 
Maceeny -> Mayence Mycenae 
ceilmop -> compile polemic 
aegilnortu -> regulation urogenital 
aehors -> ashore hoarse 
Eeir -> Eire Erie 
adeiimssv -> admissive misadvise 
aglnuu -> ungual ungula 
eepru -> puree rupee 
eeprs -> perse spree 
adeegnru -> dungaree underage 
ceilppr -> clipper cripple 
hiiknps -> kinship pinkish 
eeimrrtt -> remitter trimeter 
aaegssu -> assuage sausage 
aclorsu -> carolus oscular 
hlot -> holt loth 
.copr -> corp. proc. 
hlsu -> lush shul 
aeegnrst -> estrange sergeant 
crstuy -> crusty curtsy 
ehkoorsuw -> housework workhouse 
addeln -> dandle landed 
addelw -> dawdle waddle 
addelr -> ladder raddle 
aehknr -> hanker harken 
addenr -> dander darned 
eimpru -> impure umpire 
addens -> dedans sadden 
addemn -> damned demand madden 
aeinnottt -> attention tentation 
aehkrs -> kasher shaker 
aeelmptt -> palmette template 
eersv -> serve sever verse 
eerst -> ester reest reset steer stere terse 
aeilnrt -> latrine ratline reliant trenail 
aeilnst -> elastin salient saltine 
 aeenoqrrttu -> quarter note quarter tone 
ehikrs -> shriek shrike 
eertv -> evert revet 
aflot -> aloft float 
aeilnor -> aileron alerion alienor 
aeilnot -> elation toenail 
aehmnt -> anthem hetman 
cdeiimorty -> iridectomy mediocrity 
abenort -> baronet reboant 
Macehil -> Meilhac Michael 
aehlrt -> halter lather thaler 
ceeeipprtv -> perceptive preceptive 
hilot -> litho thiol 
eervy -> every veery 
girst -> grist grits 
enost -> onset stone 
aeilmpr -> impearl lempira 
abcor -> carob cobra 
 aefinrt -> fine art fire ant 
aehrsw -> hawser washer 
aehrtt -> hatter threat 
aaegmnt -> magenta magnate 
aehrty -> earthy hearty 
 aceeirtw -> ice water water ice 
aeilmnn -> lineman melanin 
aeilmnp -> impanel maniple 
aeilmnr -> marline mineral 
aeilmns -> malines seminal 
aeilmnt -> ailment aliment 
aacdeeimt -> acetamide emaciated 
abcer -> acerb brace caber 
aailmn -> animal lamina 
afost -> fatso softa 
eoppry -> popery pyrope 
aailrt -> lariat latria 
aailsv -> saliva salvia 
aehimprsst -> mastership shipmaster 
aaeenrst -> arsenate serenata 
cceilr -> circle cleric 
aaceinrt -> carinate craniate 
cceiil -> cilice icicle 
abblu -> babul bubal 
ennot -> nonet tenno tenon tonne 
abeinooprrt -> probationer reprobation 
aehlrst -> harslet slather 
aehlrty -> earthly lathery 
aaimnr -> airman marina 
hoop -> hoop pooh 
aacclru -> accrual caracul 
hops -> posh shop 
host -> host shot tosh 
  abeffillor -> ball of fire bill of fare 
cdeiinorst -> directions discretion 
ciloorst -> colorist cortisol 
deggor -> dogger gorged 
efmnrtuy -> frumenty furmenty 
abcdeenorrt -> centerboard centreboard 
Macinor -> Marconi Minorca 
deggru -> grudge rugged 
aeinnotv -> innovate venation 
ccehio -> choice echoic 
aciillnos -> collinsia isoclinal 
abers -> saber sabre 
aberz -> braze zebra 
aehprt -> tephra threap 
aehprs -> phrase seraph 
abest -> baste beast tabes 
abemr -> amber bream 
abemy -> beamy embay maybe 
aaeinoprrt -> praetorian reparation 
bdeefir -> debrief fibered 
eoprtu -> pouter troupe 
eoprst -> poster presto 
abekr -> baker brake break 
abelm -> amble blame 
abelt -> blate bleat table 
abelr -> baler blare blear 
eoprrt -> porter pretor report 
abegl -> bagel belga gable 
beoorz -> boozer rebozo 
ddsu -> duds sudd 
aaceiptt -> apatetic capitate 
eerrsv -> revers server 
eimoprs -> promise semipro 
efirtt -> fitter titfer 
acelnru -> lucarne nuclear unclear 
acelnps -> enclasp spancel 
egilno -> eloign legion 
abdor -> board broad 
eehoorsvw -> howsoever whosoever 
ADN -> DNA NAD 
deer -> deer dree rede reed 
deen -> dene need 
deem -> deem deme meed 
acelostu -> lacteous osculate 
deiv -> dive vide 
deit -> diet edit tide tied 
deir -> dire ride 
deis -> ides side 
abdir -> braid rabid 
dein -> dine nide 
deil -> deil deli idle lied 
deim -> dime idem 
degilr -> gilder girdle glider 
AMR -> MRA RAM 
abdeg -> badge debag 
abdeo -> abode adobe 
demo -> demo dome mode 
abder -> ardeb barde beard bread debar 
delw -> lewd weld 
delo -> dole lode 
deot -> dote toed 
deor -> doer redo rode 
deos -> does dose 
hnorty -> rhyton thorny 
deny -> deny dyne 
denu -> dune nude 
dent -> dent tend 
deno -> done node 
deginr -> engird ringed 
anoprt -> parton patron tarpon 
ATV -> TVA VAT 
desu -> dues used 
acgilnps -> clasping scalping 
eerstt -> setter street tester 
cdeeirttu -> certitude rectitude 
eeemst -> esteem mestee 
beegno -> begone engobe 
grsuy -> gyrus surgy 
eglorv -> glover grovel 
ensux -> nexus unsex 
aadelmns -> dalesman leadsman 
efhirs -> fisher sherif 
bdeilru -> builder rebuild 
acilmnopt -> complaint compliant 
hrtu -> hurt ruth 
eikrrst -> skirret striker 
aeknrt -> ranket tanker 
 aacglos -> coal gas gas coal 
aacimnor -> macaroni marocain 
bdenru -> burden burned 
deeehlw -> wheedle wheeled 
ciilopst -> colpitis politics 
dgir -> gird grid 
Aadr -> Adar Arad 
beirst -> bestir bister bistre 
hstu -> shut thus tush 
denprtu -> prudent uptrend 
aginpprst -> strapping trappings 
alnoos -> saloon solano 
eenprst -> present serpent 
eloprsu -> leprous pelorus sporule 
oprstu -> sprout stupor 
adeinst -> instead sainted 
aillortt -> littoral tortilla 
benorstu -> burstone rubstone 
bdeinrssu -> burnsides sideburns 
cffsu -> cuffs scuff 
acinnost -> canonist sanction 
eehprs -> herpes sphere 
adginr -> daring gradin 
 aabceeglnoors -> barnacle goose goose barnacle 
 ceefhils -> ice shelf shelf ice 
beeerz -> beezer breeze 
abins -> basin sabin 
abinr -> bairn brain 
eeilmnost -> limestone milestone 
aeeimnnortu -> enumeration mountaineer 
aaclnu -> canula lacuna 
aaclrs -> lascar rascal sacral scalar 
aaclsu -> casual causal 
hitwy -> whity withy 
diks -> disk skid 
dikn -> dink kind 
eiprst -> esprit priest sprite stripe 
dilo -> idol lido olid 
aeegilnnt -> eglantine inelegant 
abhmo -> abmho abohm 
aekmrr -> marker remark 
adeilms -> misdeal mislead 
adeilnn -> annelid lindane 
abilr -> brail libra 
abiln -> binal blain 
FHS -> FSH SHF 
aalmnu -> alumna manual 
defiiln -> infidel infield 
aeeioprtv -> evaporite operative 
abcmot -> combat tombac 
aalmps -> lampas plasma 
aeegnrt -> grantee greaten reagent 
 aadeeght -> get ahead head gate 
emoprt -> emptor trompe 
ablor -> labor lobar 
aortt -> ottar troat 
bgilno -> globin goblin 
aekrst -> skater strake streak 
aeegmmt -> gemmate tagmeme 
abcnor -> carbon corban 
abeirsty -> bestiary sybarite 
cefirty -> certify rectify 
aeinrrst -> restrain strainer 
ehprsy -> sphery sypher 
aachmort -> achromat trachoma 
aissst -> assist stasis 
addegimnn -> demanding maddening 
ioprst -> prosit tripos 
aceorrt -> acroter creator reactor 
aeggnr -> ganger grange 
dlot -> dolt told 
deeimrt -> demerit dimeter merited 
beeimr -> bemire bireme 
aeeglnr -> enlarge general 
histty -> shitty stithy 
emorrt -> termor tremor 
abnru -> buran unbar urban 
dmoo -> doom mood 
eefiilnrt -> infertile interfile 
Jaen -> Jane Jean Jena 
deeginrs -> designer resigned 
eglntu -> englut gluten 
abmru -> rumba umbra 
abmry -> ambry barmy 
aostt -> stoat toast 
aghilmort -> algorithm logarithm 
acceip -> icecap ipecac 
ailprsu -> parulis spirula 
acdeeilnn -> celandine decennial 
eelssv -> selves vessel 
aeilnort -> oriental relation 
eeginnu -> genuine ingenue 
ghilopstt -> spotlight stoplight 
gnorw -> grown wrong 
aadehilr -> headrail railhead 
aemnoru -> enamour neuroma 
eeimnss -> nemesis siemens 
aacflu -> facula faucal 
ceeilrt -> reticle tiercel 
eloruv -> louver louvre velour 
elorst -> ostler sterol 
Radehilnn -> Rheinland Rhineland 
door -> door odor rood 
ceeilns -> license silence 
dopr -> dorp drop prod 
doru -> dour duro 
boost -> boost boots 
acchiort -> thoracic trochaic 
abort -> abort boart tabor 
afgimnr -> farming framing 
elostu -> solute tousle 
acdiinorty -> dictionary indicatory 
ceenorrtv -> converter reconvert 
eehinr -> herein inhere 
Abilno -> Albion Alboin 
 acghhinttw -> night watch watch night 
eeimprs -> emprise premise spireme 
Saadi -> Saadi Saida 
ceeinrs -> ceresin sincere 
aceiinpstt -> antiseptic psittacine 
 deefirr -> fire red red fire 
Raelv -> Ravel Reval 
aacetv -> caveat vacate 
acefrtu -> facture furcate 
acfiinnort -> infarction infraction 
abeefilr -> afebrile balefire 
lmpuy -> lumpy plumy 
ailmorty -> molarity morality 
bdeinr -> binder inbred 
bdeilo -> boiled bolide 
 abeegrstu -> beet sugar sugar beet 
efhls -> flesh shelf 
acinnot -> actinon contain 
dstuy -> dusty study 
deerrss -> dresser redress 
dstu -> dust stud 
Saant -> Santa Satan 
aeeenrtv -> enervate venerate 
aaccimnor -> carcinoma macaronic 
ademnru -> duramen maunder unarmed 
aelnpty -> aplenty penalty 
-inort -> intro- nitro- 
ademnnu -> mundane unnamed 
aeghnorv -> hangover overhang 
aeghnopt -> heptagon pathogen 
aceinort -> creation reaction 
acinopt -> caption paction 
acinoss -> caisson cassino 
aceinotv -> conative invocate 
degiklo -> doglike godlike 
acinotu -> auction caution 
ceiinrsu -> incisure sciurine 
aceinopr -> apocrine procaine 
mnoo -> mono moon 
mnor -> morn norm 
aaenpst -> anapest peasant 
accehimst -> catechism schematic 
aeimrstt -> mistreat teratism 
bdegir -> begird bridge 
Cahiinrst -> Christian Christina 
eeerrsv -> reserve reverse 
accehimns -> mechanics mischance 
efiry -> fiery reify 
cdeeirst -> discreet discrete 
efirr -> firer frier 
hnort -> north thorn 
beimru -> erbium imbrue 
beimrt -> timber timbre 
 aeilllnqsu -> line squall squall line 
Bellosw -> Bellows Boswell 
mopr -> prom romp 
moor -> moor room 
Maersu -> Maseru Mauser 
abgnor -> barong brogan 
accdinor -> cancroid draconic 
deestv -> devest vested 
 aegghilnrt -> range light right angle 
 deeemorsu -> deer mouse mouse deer 
 CJehirssstu -> Christ Jesus Jesus Christ 
ceinoprssu -> percussion supersonic 
 ceiilprst -> list price price list 
bdemoor -> bedroom boredom 
aachimrs -> archaism charisma 
efinr -> finer infer 
achnstu -> canthus staunch 
efilt -> filet flite 
efilr -> flier lifer rifle 
eegimnt -> meeting teeming 
deiinors -> derision resinoid 
aeennprtt -> penetrant repentant 
aacimn -> caiman maniac 
aacinr -> arnica carina 
akrst -> karst stark 
abceilr -> caliber calibre 
dinopu -> dupion unipod 
abceiss -> abscise scabies 
Feorrst -> Forrest Forster 
ersstu -> estrus russet 
eflty -> flyte lefty 
...CGM -> C.M.G. G.C.M. 
benrtu -> brunet burnet 
aceeilnrt -> interlace reclinate 
aceinrst -> canister cisterna 
bfllowy -> blowfly flyblow 
acghhimooopprrt -> microphotograph photomicrograph 
erstuu -> suture uterus 
Baegiln -> Belgian Bengali 
cehior -> coheir heroic 
cehirt -> cither thrice 
aeloors -> aerosol roseola 
aadilnotu -> adulation laudation 
dinpuw -> upwind windup 
aeelptt -> palette peltate 
...DJS -> J.S.D. S.J.D. 
...DLS -> L.D.S. L.S.D. 
...DOS -> D.S.O. O.S.D. 
adhiloy -> holiday hyaloid 
adeeprv -> deprave pervade 
eeenruv -> revenue unreeve 
eeenrrt -> reenter terrene 
adeinort -> deration ordinate 
Lacinu -> Lucian Lucina 
adeinost -> astonied sedation 
...DPW -> D.P.W. P.W.D. 
acenoprrt -> copartner procreant 
agiilnot -> intaglio ligation 
eemort -> meteor remote 
mstu -> must smut 
ainoptu -> opuntia utopian 
efmoprr -> perform preform 
Saikt -> Sakti Sitka 
Caerrt -> Carter Crater 
Caailnor -> Carniola Carolina 
celttu -> cutlet cuttle 
aiorst -> aorist satori 
cehiorrt -> rhetoric torchier 
abcehmr -> becharm chamber 
efflrtu -> fretful truffle 
ceiinrt -> citrine crinite neritic 
ceiinrs -> irenics sericin sirenic 
aegrrt -> garret garter grater 
 CIVaehlrs -> Charles IV Charles VI 
benorz -> bonzer bronze 
aadmnorty -> damnatory mandatory 
Adeennrs -> Andersen Ardennes 
aeelnrt -> eternal teleran 
 deeloprrtt -> drop letter letter drop 
aainrst -> artisan tsarina 
acegilr -> glacier gracile 
aademn -> anadem maenad 
aeinnrstt -> instanter transient 
aeeintttv -> attentive tentative 
aeelmnp -> empanel emplane 
eeimrtt -> emitter termite 
agiln -> algin align ligan 
agilr -> argil glair 
agimo -> amigo imago 
aeprst -> repast trapes 
aeprss -> passer sparse 
deflno -> enfold fondle 
inors -> irons ornis rosin 
inopt -> pinto piton point 
efort -> fetor forte 
efrry -> ferry fryer 
aglry -> glary gyral 
dorsw -> sword words 
aglno -> along logan 
aglns -> glans slang 
aglor -> algor argol goral largo 
eehinrt -> neither therein 
eflorvy -> flyover overfly 
acdeeerst -> decastere desecrate 
ehilprt -> philter philtre 
ikln -> kiln link 
-mnoo -> mono- nomo- 
ikno -> ikon kino oink 
ikns -> sink skin 
aclopu -> copula cupola 
ikrs -> kris risk 
ikst -> kist skit 
dorwy -> dowry rowdy wordy 
aeppry -> papery prepay 
ainossu -> sanious suasion 
agghloopry -> graphology logography 
...AMR -> R.A.M. R.M.A. 
illt -> lilt till 
ilno -> lion loin noil 
...BEM -> B.E.M. M.B.E. 
abeimrtv -> ambivert verbatim 
ilmo -> milo moil 
cddeeu -> deduce deuced 
aeeginss -> agenesis assignee 
ilps -> lisp slip 
aeegintv -> agentive negative 
ilos -> silo soil 
ilst -> list silt slit 
eilrvy -> livery verily 
adeelrt -> related treadle 
eilrsv -> silver sliver 
...BCE -> B.C.E. C.B.E. 
agnry -> angry rangy 
aeloprst -> petrosal polestar 
cehiknt -> kitchen thicken 
aeellptt -> pallette platelet 
agnst -> angst stang 
agnot -> tango tonga 
agnor -> argon groan orang organ 
agnow -> gowan wagon 
defgit -> fidget gifted 
adeeiss -> disease seaside 
ahopst -> pathos potash 
aeglmn -> legman mangle 
eillrt -> rillet tiller 
agmno -> among mango 
aeglnr -> angler regnal 
aalrst -> astral tarsal 
inps -> snip spin 
adeinnoott -> denotation detonation 
ceeefnorr -> ferrocene reenforce 
inssu -> nisus sinus 
aaceiinttv -> inactivate vaticinate 
ceeginptx -> excepting expecting 
eillnt -> lentil lintel 
eoprs -> poser prose spore 
eoprt -> toper trope 
eopst -> estop stope 
eopss -> posse speos 
eopsy -> poesy sepoy 
cchltu -> clutch cultch 
acdir -> acrid caird daric 
acder -> acred cadre cedar 
beeorsv -> observe obverse verbose 
agprs -> grasp sprag 
definr -> finder friend redfin 
iort -> riot tiro trio 
ahirstt -> athirst rattish 
adeegnr -> derange grandee grenade 
adeghinprs -> headspring springhead 
adeiswy -> sideway wayside 
aeghmo -> homage ohmage 
ehlstu -> hustle sleuth 
eorsstu -> estrous tussore 
ceeeiltv -> cleveite elective 
eeehlnopt -> phenetole telephone 
eilmnr -> limner merlin 
eilnuv -> unlive unveil 
cehilno -> choline helicon 
ckory -> corky rocky 
eilnst -> enlist listen silent tinsel 
agort -> argot groat 
amnotu -> amount outman 
 aeginoppr -> organ pipe pipe organ 
anruwy -> runway unwary 
amnopt -> potman tampon 
 aabcegilnnprs -> balance spring spring balance 
aegint -> eating ingate 
aeginr -> earing gainer regain 
aegilt -> aiglet ligate 
aegiln -> genial linage 
aegimn -> enigma gamine 
aegimr -> maigre mirage 
aegirt -> gaiter triage 
eilnos -> insole lesion 
eilnpu -> lineup lupine unpile 
eilnps -> spinel spline 
eipsss -> sepsis speiss 
eortw -> tower wrote 
eortv -> overt trove voter 
eortu -> outer route 
eorsv -> servo verso 
eorst -> store torse 
eorsw -> serow swore worse 
eeft -> feet fete 
eefr -> fere free reef 
eefl -> feel flee 
eels -> else lees seel 
eelr -> leer reel 
aabelmst -> blastema lambaste 
...GOP -> G.O.P. G.P.O. 
eekp -> keep peek 
eekn -> keen knee 
eekl -> keel leek 
eemt -> meet mete teem 
acdghotw -> dogwatch watchdog 
eerw -> ewer were 
eerv -> ever veer 
eert -> rete tree 
eers -> seer sere 
cemorstu -> costumer customer 
eginrst -> resting stinger 
beeiilmprss -> impressible permissible 
celrtu -> cutler reluct 
abilopr -> bipolar parboil 
aceno -> canoe ocean 
acenr -> crane nacre rance 
eoqtu -> quote toque 
acepr -> caper crape pacer recap 
cehinop -> chopine phocine 
ehlnop -> holpen phenol 
aceps -> scape space 
aegprs -> gasper sparge 
acekr -> crake creak 
aceln -> clean lance 
acelm -> camel macle 
acelv -> calve clave 
acelt -> cleat eclat 
acefr -> facer farce 
effi -> fief fife 
acehl -> chela leach 
acehr -> chare reach 
aceht -> cheat tache teach theca 
acehp -> chape cheap peach 
efir -> fire rife 
efil -> file lief life 
eflu -> flue fuel 
eflt -> felt left 
adiimoprst -> diatropism prismatoid 
efor -> fore froe 
efrt -> fret reft tref 
beinrtu -> tribune turbine 
abilnotu -> ablution abutilon 
adeirst -> astride diaster disrate 
acert -> caret carte cater crate react trace 
acers -> carse scare 
acerv -> carve crave 
aeeiilrtvz -> relativize revitalize 
acesu -> cause sauce 
acest -> caste cesta 
abilnoot -> boltonia lobation oblation 
aehilmorst -> isothermal thimerosal 
...HMS -> H.M.S. H.S.M. 
eghhit -> eighth height 
aegmnr -> engram german manger 
ceehlprsu -> sepulcher sepulchre 
ablmru -> brumal labrum lumbar 
aelnprsu -> purslane supernal 
aab -> aba baa 
gstuy -> gusty gutsy 
aeehhilrttw -> therewithal whitleather 
abd -> bad dab 
abg -> bag gab 
abl -> alb bal lab 
aegmmr -> gammer gramme 
abn -> ban nab 
abr -> bar bra 
abt -> bat tab 
aby -> aby bay 
aeeinprst -> pistareen sparteine 
aegmru -> maugre murage 
acm -> cam mac 
acr -> arc car 
act -> act cat 
add -> add dad 
adh -> dah had 
adg -> dag gad 
adm -> dam mad 
adp -> dap pad 
adw -> daw wad 
ael -> ale lea 
aen -> ane nae 
aep -> ape pea 
aer -> are ear era 
aet -> ate eat eta tea 
aey -> aye yea 
Baal -> Baal Bala 
aft -> aft fat 
cceinor -> cornice crocein 
agm -> gam mag 
agl -> gal lag 
ago -> ago goa 
agn -> gan nag 
ags -> gas sag 
agr -> gar rag 
agt -> gat tag 
istw -> wist wits 
ahp -> hap pah 
ahs -> ash has 
achmr -> charm march 
ahy -> hay yah 
aim -> aim ami 
ain -> ain ani 
achnt -> chant natch 
air -> air ria 
eglu -> glue luge 
ako -> koa oak oka 
aorrwy -> arrowy yarrow 
eglo -> loge ogle 
alp -> alp lap pal 
alt -> alt lat 
alw -> awl law 
achin -> chain china 
amr -> arm mar ram 
amt -> mat tam 
acpstu -> catsup upcast 
amy -> may yam 
anp -> nap pan 
ant -> ant tan 
anw -> awn wan 
any -> any nay 
bgnoo -> bongo boong 
aor -> oar ora 
aoz -> azo zoa 
cgilnoooy -> coniology iconology 
apr -> par rap 
apt -> apt pat tap 
aps -> asp pas sap spa 
egor -> ergo goer gore ogre 
apy -> pay pya yap 
egry -> grey gyre 
art -> art rat tar 
Aeirs -> Aesir Aries 
arw -> raw war 
aeeghhloopprtty -> phototelegraphy telephotography 
aciil -> cilia iliac 
asw -> saw was 
atw -> taw wat 
awy -> way yaw 
chiiorst -> historic orchitis 
abilnrtu -> tribunal turbinal 
cdhior -> orchid rhodic 
bde -> bed deb 
adegiilnot -> gadolinite gelatinoid 
bdi -> bid dib 
aegnor -> onager orange 
bdu -> bud dub 
ben -> ben neb 
bey -> bey bye 
bgi -> big gib 
aegnrt -> argent garnet 
bgo -> bog gob 
aegnrr -> garner ranger 
celort -> colter lector 
celors -> closer cresol 
bin -> bin nib 
bis -> bis sib 
ehir -> heir hire 
ehlr -> herl lehr 
-ilop -> lipo- plio- 
ehnt -> hent then 
bnu -> bun nub 
cginorsu -> coursing scouring 
bor -> orb rob 
ehos -> hose shoe 
acgim -> gamic magic 
aceeiinnrt -> creatinine incinerate 
ehrs -> hers resh 
bru -> bur rub 
bsu -> bus sub 
ehtw -> thew whet 
aaceinrst -> ascertain sectarian 
eeeilnst -> enlistee selenite 
btu -> but tub 
aeprstt -> spatter tapster 
cdo -> cod doc 
chi -> chi hic 
eilv -> evil live veil vile 
eilr -> riel rile 
eiln -> lien line 
eilm -> lime mile 
eikt -> kite tike 
eikp -> kepi pike 
einv -> vein vine 
eimt -> emit item mite time 
eims -> mise semi 
eimr -> emir mire rime 
eimn -> mien mine 
ceooty -> coyote oocyte 
eipr -> peri pier ripe 
eirw -> weir wire 
eirt -> rite tier tire 
eirs -> reis rise sire 
cru -> cru cur 
eivw -> view wive 
abbert -> barbet rabbet 
ccennot -> concent connect 
abbelr -> barbel rabble 
del -> eld led 
den -> den end 
deo -> doe ode 
dew -> dew wed 
eoprstu -> petrous posture septuor 
eoprstt -> protest spotter 
dey -> dey dye 
dgi -> dig gid 
dgo -> dog god 
aabmnt -> bantam batman 
dim -> dim mid 
aciru -> auric curia 
anorsuu -> anurous uranous 
acitt -> attic tacit 
dlo -> dol old 
aeghilrt -> litharge thirlage 
dmo -> dom mod 
acint -> actin antic 
dno -> don nod 
inooprst -> positron sorption 
dor -> dor rod 
dot -> dot tod 
dou -> duo oud udo 
acips -> aspic spica 
Madeno -> Menado Modena 
abeehinrt -> hibernate inbreathe 
acegilrtu -> curtilage graticule 
Deelmor -> Delorme Demerol 
aabmortu -> marabout tamboura 
deiint -> indite tineid 
eorrtu -> router tourer 
eorrtt -> retort rotter 
aadegry -> drayage yardage 
eorrst -> resort roster 
acflno -> falcon flacon 
aeilmttu -> mutilate ultimate 
eel -> eel lee 
eew -> ewe wee 
egl -> gel leg 
egn -> eng gen 
eegnrt -> gerent regent 
eil -> lei lie 
ekl -> elk lek 
elm -> elm mel 
ely -> ley lye 
eno -> eon one 
ent -> net ten 
ens -> ens sen 
enw -> new wen 
eor -> ore roe 
eow -> owe woe 
epr -> per rep 
epy -> pye yep 
esu -> sue use 
aclps -> clasp scalp 
Daeinr -> Dairen Darien Derain 
apsty -> pasty patsy 
eorstv -> stover strove 
eorstu -> ouster souter 
eorsty -> oyster storey 
Daeiln -> Daniel Delian 
abehoostu -> boathouse houseboat 
efginr -> finger fringe 
elno -> enol leno lone 
for -> for fro 
elov -> love vole 
elos -> lose sloe sole 
elor -> lore orle role 
elop -> lope pole 
elry -> lyre rely 
elru -> lure rule 
elsu -> lues slue 
adehinp -> headpin pinhead 
aceeinrt -> centiare creatine increate 
eeiprrs -> reprise respire 
deikln -> kindle linked 
aprsy -> raspy spray 
aprst -> parts sprat strap traps 
aclor -> carol claro coral 
ddeenu -> denude dudeen 
ailmrstu -> altruism ultraism 
abbder -> barbed dabber 
ghu -> hug ugh 
gip -> gip pig 
cdeiillno -> celloidin decillion 
eefhlrs -> flesher herself 
aabb -> abba baba 
gmu -> gum mug 
ceefprt -> perfect prefect 
gnu -> gnu gun 
got -> got tog 
emot -> mote tome 
emor -> more omer 
emop -> mope poem pome 
emsw -> mews smew 
aagl -> alga gala 
gtu -> gut tug 
aabflott -> faltboat flatboat 
aajr -> ajar raja 
acellops -> collapse escallop 
almost -> almost smalto 
aant -> anta tana 
acost -> ascot coast costa 
aaelnprt -> parental paternal prenatal 
hip -> hip phi 
deefgin -> feeding feigned 
enno -> neon none 
hmo -> mho ohm 
abdr -> bard brad drab 
hoo -> hoo oho 
hot -> hot tho 
abde -> abed bade bead 
how -> how who 
ceorsu -> cerous course crouse source 
ceorst -> corset escort scoter sector 
abdu -> baud daub 
enot -> note tone 
enos -> nose sone 
enop -> nope open peon pone 
enox -> exon oxen 
enrt -> rent tern 
aber -> bare bear brae 
abem -> beam bema 
abel -> able bael bale 
aben -> bane bean 
abek -> bake beak 
abet -> abet bate beat beta 
abht -> baht bath 
entw -> newt went 
abgr -> brag garb grab 
ensw -> news sewn 
enst -> nest sent 
ablmnruu -> alburnum laburnum 
chiiinorsst -> histrionics trichinosis 
ablm -> balm lamb 
achiort -> chariot haricot 
abnr -> barn bran 
ceortv -> covert vector 
abor -> boar bora 
abtu -> abut tabu tuba 
acnst -> canst scant 
abst -> bast bats stab 
acnno -> ancon canon 
acnny -> canny nancy 
acnor -> acorn racon 
acnot -> canto octan 
eioprst -> reposit riposte 
acenors -> coarsen narcose 
ikn -> ink kin 
ilt -> lit til 
imn -> min nim 
imr -> mir rim 
inp -> nip pin 
int -> nit tin 
eopt -> poet tope 
eops -> epos peso pose 
eopr -> pore rope 
acdi -> acid cadi 
acde -> cade dace 
ipt -> pit tip 
ips -> psi sip 
eorv -> over rove 
eort -> rote tore 
eors -> rose sore 
eory -> oyer yore 
acep -> cape pace 
acer -> acre care race 
acen -> acne cane 
acem -> acme came mace 
aceh -> ache each 
irs -> sir sri 
acet -> cate tace 
achr -> arch char 
eotv -> veto vote 
aabcdkrw -> backward drawback 
ist -> its sit 
deeinrst -> inserted resident 
mooorrtw -> moorwort tomorrow 
acly -> acyl clay lacy 
aclo -> coal cola 
aclm -> calm clam 
ackr -> cark rack 
acks -> cask sack 
aaeimnt -> amentia animate 
ackl -> calk kcal lack 
acmr -> cram marc 
acpr -> carp crap 
adeempst -> stampede stepdame 
acox -> coax coxa 
acot -> coat taco 
acst -> cast scat 
inortt -> intort triton 
aceerrt -> caterer retrace terrace 
ailopst -> apostil topsail 
aehnopt -> phaeton phonate 
 IPVhiilp -> Philip IV Philip VI 
epry -> prey pyre 
adem -> dame made mead 
adel -> dale deal lade lead 
adeg -> aged egad 
adef -> deaf fade 
adei -> aide idea 
adeh -> hade head 
adez -> adze daze 
adew -> awed wade 
ader -> dare dear read 
adhs -> dash shad 
adgr -> darg drag grad 
epst -> pest sept step 
adgo -> dago goad 
adis -> dais said 
adir -> arid raid 
eoqrstu -> questor torques 
adim -> amid maid 
adil -> dial laid 
adiv -> avid diva 
adlu -> auld dual laud 
degnoru -> guerdon undergo 
adnw -> dawn wand 
adnr -> darn nard rand 
dginy -> dingy dying 
aacelmr -> cameral caramel ceramal 
dgino -> dingo doing 
adot -> dato toad 
adrw -> draw ward 
adry -> dray yard 
adrt -> dart drat 
..BC -> B.C. C.B. 
..BO -> B.O. O.B. 
..BP -> B.P. P.B. 
..BM -> B.M. M.B. 
..CI -> C.I. I.C. 
..CD -> C.D. D.C. 
..CP -> C.P. P.C. 
..CO -> C.O. O.C. 
..CR -> C.R. R.C. 
..DJ -> D.J. J.D. 
..DF -> D.F. F.D. 
..DP -> D.P. P.D. 
..DS -> D.S. S.D. 
..DO -> D.O. O.D. 
..ER -> E.R. R.E. 
..GP -> G.P. P.G. 
..GO -> G.O. O.G. 
acprs -> craps scarp scrap 
..IV -> I.V. V.I. 
..MS -> M.S. S.M. 
..MP -> M.P. P.M. 
aeefhrt -> feather terefah 
..OP -> O.P. P.O. 
aefl -> feal flea leaf 
aghmnoopr -> monograph phonogram 
..PS -> P.S. S.P. 
aceeirtv -> creative reactive 
aefr -> fare fear frae 
aeft -> fate feat 
aehr -> hare hear rhea 
aehm -> ahem hame 
aehl -> hale heal 
aeht -> hate heat 
aegp -> gape page peag 
aegr -> gear rage 
aegm -> game mage 
aejn -> jane jean 
aelt -> late tael tale teal 
aelw -> wale weal 
aelv -> lave vale veal 
aelp -> leap pale peal plea 
aels -> lase sale seal 
aelr -> earl rale real 
aelm -> lame male meal 
aeln -> elan lane lean 
aelz -> laze zeal 
aekt -> take teak 
aekl -> kale lake leak 
aekm -> kame make 
aekw -> wake weak weka 
aenw -> anew wane wean 
aenv -> nave vane vena 
aenr -> earn near 
aent -> ante etna neat 
aenp -> nape neap pane pean 
aemr -> mare ream 
aemt -> mate meat tame team 
aems -> mesa same seam 
aemn -> amen mane mean name 
aept -> pate peat tape 
aeps -> apse pase spae 
aepr -> pare pear rape reap 
aerw -> ware wear 
aerv -> aver rave 
aery -> aery eyra yare year 
aers -> arse rase sear sera 
aerr -> rare rear 
aert -> rate tare tear 
aesy -> easy eyas 
aest -> east eats sate seat seta 
aesv -> save vase 
..ap -> a.p. p.a. 
adeilttu -> altitude latitude 
acimopt -> apomict potamic 
..cp -> c.p. p.c. 
Aerstu -> Atreus Auster 
..eo -> e.o. o.e. 
almor -> molar moral 
aaceeinnrss -> necessarian renaissance 
almpy -> amply palmy 
almps -> plasm psalm 
acimost -> atomics somatic 
..gv -> g.v. v.g. 
bcmoo -> combo coomb 
aceillnor -> collinear coralline 
almru -> larum mural rumal 
..iv -> i.v. v.i. 
aeeilrtv -> levirate relative 
aeeilrtt -> laterite literate 
deinsty -> density destiny 
aeirstt -> artiste striate 
low -> low owl 
..mp -> m.p. p.m. 
elnost -> stolen telson 
..os -> o.s. s.o. 
ersu -> ruse sure user 
erst -> erst rest 
afin -> fain naif 
aflo -> foal loaf 
belmrtu -> tumbler tumbrel 
eelortuv -> revolute truelove 
cceos -> cosec secco 
afrt -> fart raft 
eefhrrs -> fresher refresh 
ccorsu -> crocus succor 
belstu -> bustle sublet subtle 
elnpty -> pentyl plenty 
aenptt -> patent patten 
alloy -> alloy loyal 
aabdor -> aboard abroad 
allot -> allot atoll 
aenprt -> arpent entrap parent trepan 
einorssu -> neurosis resinous 
deinrtu -> intrude turdine untried 
mot -> mot tom 
estt -> sett stet test 
eiimnoprss -> impression permission 
aghs -> gash shag 
estw -> stew west 
mtu -> mut tum 
aglo -> gaol goal 
aeilmnrt -> terminal tramline 
agnt -> gnat tang 
agns -> sang snag 
agot -> goat toga 
egorsu -> grouse rugose 
bdelorw -> bowlder lowbred 
acginot -> coating cotinga 
gotuy -> gouty guyot 
aceenrt -> centare crenate 
not -> not ton 
now -> now own won 
alopr -> parol polar 
nru -> run urn 
aeilnprty -> interplay painterly 
Bnor -> Born Brno 
ahhs -> hash shah 
alorv -> valor volar 
ntu -> nut tun 
ahlt -> halt lath 
ahlu -> haul hula 
ahkn -> ankh hank khan 
ahnt -> tanh than 
ahms -> mash sham 
Baels -> Basel Basle 
Baeir -> Beira Beria 
ahps -> hasp pash 
ahor -> hoar hora 
ahrt -> hart rath tahr thar 
ahtw -> thaw what 
ahsy -> ashy shay 
ahsw -> shaw shwa wash 
aadeimst -> adamsite diastema 
abcdenosu -> casebound subdeacon 
Aacehnr -> Arachne Archean 
alnuy -> unlay yulan 
eghin -> hinge neigh 
acginrv -> carving craving 
abeinrttu -> tribunate turbinate 
enrrtu -> return turner 
eeinostt -> noisette teosinte 
opt -> opt pot top 
opw -> pow wop 
aacegnr -> carnage cranage 
ort -> rot tor 
nooprt -> pronto proton 
otw -> tow two wot 
alnot -> talon tolan tonal 
noopsy -> snoopy spoony 
alnos -> salon solan 
ailr -> aril lair liar lira rail rial 
abdeelnor -> banderole bandoleer 
ailn -> anil lain nail 
ainsstu -> issuant sustain 
ailt -> alit tail 
ailv -> vail vial 
aikl -> kail kali 
aikn -> akin kain 
aiks -> saki sika 
ainr -> rain rani 
aint -> anti tain 
ainp -> nipa pain 
nosu -> nous onus 
ainv -> vain vina 
aimn -> main mina 
aimm -> imam maim 
inoopt -> option potion 
notw -> nowt town wont 
airs -> airs sari 
Aalst -> Aalst Atlas 
ehoopstu -> housetop pothouse 
eforst -> forest foster 
aceelpr -> percale replace 
aceelns -> cleanse scalene 
aceelnv -> enclave valence 
psu -> pus sup 
aacelpstu -> aspectual capsulate 
 emoorsss -> moss rose rose moss 
adeilprt -> dipteral tripedal 
ajot -> jato jota 
hoost -> shoot sooth 
inoorst -> isotron nitroso torsion 
alpsy -> palsy splay 
aknr -> knar rank 
akno -> kaon koan 
-enot -> ento- teno- 
akmo -> amok mako 
alpty -> platy typal 
aenttu -> attune tauten 
akoy -> kayo okay 
mnotu -> mount notum 
deeirssv -> disserve dissever 
akst -> skat task 
acdmnory -> dormancy mordancy 
abcceir -> acerbic breccia 
ceilmopry -> micropyle polymeric 
hortw -> throw worth wroth 
eflrstu -> fluster restful 
hostu -> shout south 
 GIVeegor -> George IV George VI 
almo -> loam mola 
almp -> lamp palm 
alms -> alms slam 
almu -> alum maul 
alpy -> paly play 
alos -> also sola 
nrtu -> runt turn 
alot -> alto lota tola 
bfhilosw -> blowfish fishbowl 
alsty -> salty slaty 
emrstu -> muster stumer 
alst -> last salt slat 
Bnoru -> Bornu Bruno 
doooprst -> doorpost doorstop 
horst -> horst short 
afilmnor -> formalin informal 
cdeemoprss -> compressed decompress 
amno -> moan noma 
amny -> many myna 
Caorst -> Castor Castro 
ampr -> pram ramp 
adeilort -> idolater tailored 
amor -> mora roam 
nstu -> nuts stun 
amot -> atom moat 
adeilost -> diastole isolated sodalite 
amrt -> mart tram 
deehnort -> dethrone threnode 
ailorsty -> royalist solitary 
aceginrt -> argentic catering citrange 
aceiloosuv -> olivaceous violaceous 
Gary -> Gary Gray 
cceinnoort -> concertino concretion 
aemrsty -> mastery streamy 
aabcilms -> balsamic cabalism 
ehiknrt -> rethink thinker 
deiilmt -> delimit limited 
egoru -> rogue rouge 
egouv -> vogue vouge 
anps -> snap span 
anrt -> rant tarn 
eeiilmnt -> ilmenite melinite 
ahips -> aphis apish spahi 
antu -> aunt tuna 
orttu -> trout tutor 
-aehm -> haem- hema- 
answ -> sawn swan 
aacdginr -> carangid cardigan 
aceeiipprtt -> peripatetic precipitate 
imprsu -> primus purism 
aors -> soar sora 
egnsu -> genus negus 
aort -> rota taro 
aaimnorttu -> maturation natatorium 
ceenorsv -> conserve converse 
orstu -> stour torus 
aost -> oast stoa 
orstw -> strow worst 
orsty -> story stroy 
egnor -> genro goner 
aceilpstu -> euplastic spiculate 
abeeirrss -> brasserie brassiere 
ainnot -> anoint nation 
eggilrw -> wiggler wriggle 
deentt -> detent tented 
aeilqrtu -> quartile requital 
aesttu -> astute statue 
beelnosu -> bluenose nebulose 
aprw -> warp wrap 
aprt -> part prat rapt tarp trap 
aprs -> rasp spar 
aiorsuv -> saviour various 
apst -> past spat taps 
apsw -> swap wasp 
ekorst -> stoker stroke 
eeloprsty -> polyester proselyte 
ekorrw -> rework worker 
abeinrtu -> braunite urbanite 
afllotu -> fallout outfall 
acehimpt -> empathic emphatic 
adeiilnorrssttx -> dextrosinistral sinistrodextral 
aceimrst -> ceramist matrices 
 CFaaacdehinnnr -> Canadian French French Canadian 
fhlrtuu -> hurtful ruthful 
eiklrt -> kilter kirtle 
Cahin -> Chain Chian China 
dmooorww -> woodworm wormwood 
arty -> arty tray 
aeeilnrt -> elaterin treenail 
arst -> star tsar 
eeprst -> pester preset 
arwy -> awry wary 
egglot -> goglet toggle 
-noot -> noto- onto- 
egglru -> gurgle lugger 
eiklnw -> welkin winkle 
ahlpy -> haply phyla 
aaginrs -> sangria sarangi 
aelrttt -> tartlet tattler 
deeirs -> desire reside 
bbelru -> burble lubber rubble 
astw -> swat wast 
aswy -> sway ways yaws 
abgino -> bagnio gabion 
afiilnortt -> filtration flirtation 
eeilprt -> perlite reptile 
ehilnoopt -> lithopone phonolite 
Palu -> Paul Pula 
.eprt -> pert. pret. rept. 
.eprs -> pres. resp. 
eeiimprssv -> impressive permissive 
ainrst -> instar strain 
aelrstt -> starlet startle 
aefrrt -> frater rafter 
aaeimnotz -> amazonite anatomize 
 aehillos -> oil shale shale oil 
adeeimnnot -> denominate emendation 
 HIVenry -> Henry IV Henry VI 
eeilrst -> leister sterile 
celnosu -> counsel unclose 
ainsty -> sanity satiny 
aeeinsttt -> enstatite intestate 
deelnort -> redolent rondelet 
Tory -> Tory Troy 
deimorsu -> dimerous soredium 
adghins -> dashing shading 
gnoppu -> oppugn popgun 
prsuy -> pursy syrup 
adekn -> knead naked 
adeln -> eland laden 
adelp -> pedal plead 
adelm -> lamed medal 
adelt -> dealt delta lated 
ademr -> armed derma dream 
adehs -> heads shade 
adeim -> amide media 
ainoopprt -> appointor apportion 
Barsu -> Brusa Bursa Busra 
adehrty -> hydrate thready 
airstt -> artist strait 
adeor -> adore oared oread 
adepr -> drape padre 
-ehnopr -> nephro- phreno- 
fgilnow -> flowing fowling 
.agmr -> gram. marg. 
adert -> trade tread 
adery -> deary ready 
adder -> adder dread 
addel -> addle dedal 
eeiinoprtt -> petitioner repetition 
almtuu -> mutual umlaut 
cdehorw -> chowder cowherd 
-cenortu -> counter- re-count 
ahlloty -> loathly tallyho 
egginr -> ginger nigger 
epstu -> setup stupe upset 
aaeemnt -> emanate manatee 
adgno -> donga gonad 
deirst -> driest stride 
Maeeinss -> Messenia Messiaen 
abelrttu -> burletta rebuttal 
aaeelnps -> seaplane spelaean 
emprstu -> stumper sumpter 
eprsu -> purse sprue super 
afiinnos -> sainfoin sinfonia 
eemprsu -> presume supreme 
eprry -> perry pryer 
eeeprrsv -> perverse preserve 
ehlorst -> holster hostler 
fglo -> flog golf 
acehinort -> anchorite antechoir 
iklns -> links slink 
hinpsu -> punish unship 
chior -> choir ichor 
adior -> aroid radio 
adipv -> pavid vapid 
aeflty -> fealty featly 
cekorr -> corker rocker 
dloor -> dolor drool 
aeinsst -> entasis sestina 
clnosu -> clonus consul 
aeinstt -> instate satinet 
adiry -> dairy diary 
aeflru -> earful ferula 
 acccennorrttuu -> account current current account 
adilr -> laird liard 
chiil -> chili lichi 
adinv -> divan viand 
adinr -> dinar drain nadir 
bhort -> broth throb 
acorrt -> carrot trocar 
aacegilln -> englacial galenical 
deilwy -> widely wieldy 
aeinrtt -> intreat nitrate tertian 
aeinrtu -> taurine urinate 
adhrs -> hards shard 
adhry -> hardy hydra 
aeinrrt -> terrain trainer 
aeinrst -> retsina stearin 
adhij -> hadji jihad 
 ILVXiosu -> Louis XIV Louis XVI 
filt -> flit lift 
giiknrst -> skirting striking 
fino -> fino foin 
fist -> fist sift 
bceilor -> bricole corbeil 
firt -> frit rift 
ceelorst -> corselet selector 
ceknor -> conker reckon 
eginrrst -> ringster stringer 
celrtuy -> cruelty cutlery 
aeinqtu -> antique quinate 
 abcdhlooors -> board school school board 
bdegu -> budge debug 
Wfloo -> Wolof Woolf 
bdeim -> bedim imbed 
bdeit -> bidet debit 
aagnorrt -> arrogant tarragon 
adefilnot -> deflation defoliant 
bdeer -> brede breed 
deinnt -> indent intend tinned 
deinnr -> dinner endrin 
bdeel -> bedel bleed 
deintu -> dunite united 
deinrt -> rident tinder 
deinrv -> driven verdin 
abcefikr -> backfire fireback 
aceiilnst -> inelastic sciential 
cceennort -> concenter concentre 
aeinprt -> painter pertain 
aeinpst -> panties sapient 
abddeiors -> broadside sideboard 
aefkry -> fakery freaky 
ceiklrst -> stickler strickle 
deiort -> editor triode 
ddeimn -> midden minded 
-epr -> per- pre- 
ciillnoot -> cotillion octillion 
 aacegnrsu -> cane sugar sugar cane 
bbinor -> ribbon robbin 
aadeehmrst -> headmaster headstream 
